00000000000000
01111110000000
01111111111100
01111111111100
01111110000000
01111100000000
01001000000000
00000000000000
